@####/...##
.....#.#...
.##.##....#
...####.#..
##.#.......
#..##.##...
..##..#....
.....##.#..
###..##.#..
...........
.......#...